000000208
920004000
000208071
003600000
000709000
000000640
860401000
000900027
209000000

